11111111111111111111111
1P000000000000000000001
11111111111111111111101
100000000000000000000C1
10111111111111111111111
1C0000000000000000000E1
11111111111111111111111